============#####
=..........======
=................
=..........======
============#####