============#####=======
=..........======......=
=......................=
=..........======......=
============#####==.====