============#####========
=..........======.......=
=.......................=
=.......................=
===================..====
                  =..=
                  =..=
                  =..=
                  =..=
============#####==..====
=..........======.......=
=.......................=
=..........=======......=
============#####==..====